!SIL SIL
<SPOKEN_NOISE> SPN
<UNK> SPN
一个	yi iL iH g elH elL
一个	yi iL iH g elM elM
一事	yi iL iH sh ibH ibL
一介	yi iL iH ji ehH ehL
一名	yi iH iL mi elL ngH
一周	yi iH iL zh oH uH
一夜	yi iL iH yi ehH ehL
一带	yi iL iH d aH ehL
一张	yi iH iL zh aaH ngH
一株	yi iH iL zhu uH uH
一样	yi iL iH yi aaH ngL
一股	yi iH iL gu uL uL
一般	yi iH iL b aH nnH
万宝龙	wu aH nnL b aaL oL lu uL ngH
三	s aH nnH
上	sh aaH ngL
上	sh aaL ngL
上	sh aaM ngM
上任	sh aaH ngL r elH nnL
上佳	sh aaH ngL ji aH aH
上达	sh aaH ngL d aL aH
下	xi aH aL
下官	xi aH aL gu aH nnH
下联	xi aH aL li aL nnH
不久	bu uH uL ji oL uL
不仅	bu uH uL ji iL nnL
不变	bu uL uH bi aH nnL
不幸	bu uL uH xi elH ngL
不得	bu uH uL d elL elH
不悔	bu uH uL hu ehL iL
不是	bu uL uH sh ibH ibL
不过	bu uL uH gu oH oL
与	yv vL vL
与	yv vH vL
与	yv vL vH
丐帮	g aH ehL b aaH ngH
专家	zhu aH nnH ji aH aH
丛台区	cu uL ngH t aL ehH qv vH vH
两侧	li aaL ngL c elH elL
两名	li aaL ngL mi elL ngH
两轮	li aaL ngL lu elL nnH
两颗	li aaL ngL k elH elH
个	g elH elL
个	g elL elL
中	zhu uH ngH
中	zhu uH ngL
中南海	zhu uH ngH n aL nnH h aL ehL
中卫	zhu uH ngH wu ehH iL
中国	zhu uH ngH gu oL oH
中有	zhu uH ngH yi oL uL
中特	zhu uH ngH t elH elL
中盘	zhu uH ngH p aL nnH
丰	f elH ngH
丰饶	f elH ngH r aaL oH
丹	d aH nnH
为	wu ehL iH
为	wu ehH iL
为核心	wu ehL iH h elL elH xi iH nnH
为父	wu ehH iL fu uH uL
主	zhu uL uL
主要领导	zhu uL uL yi aaH oL li elL ngL d aaL oL
之人	zh ibH ibH r elL nnH
乖谬	gu aH ehH mi oH uL
也是	yi ehL ehL sh ibH ibL
乡	xi aaH ngH
乳儿	ru uL uL ge erL erH
了	l elM elM
了	li aaL oL
二	ge erH erL
二传	ge erH erL chu aL nnH
于	yv vL vH
云和	yv elL nnH h elL elH
互敬	hu uH uL ji elH ngL
亥	h aH ehL
产儿	ch aL nnL ge erL erH
亭	ti elL ngH
人	r elL nnH
人像	r elL nnH xi aaH ngL
人去	r elL nnH qv vH vL
人对	r elL nnH du ehH iL
人氏	r elL nnH sh ibH ibL
仁爱	r elL nnH ga aH ehL
今天	ji iH nnH ti aH nnH
从	cu uL ngH
他到	t aH aH d aaH oL
他的	t aH aH d elM elM
代	d aH ehL
以	yi iL iL
仿佛	f aaL ngL fu uL uH
众多	zhu uH ngL du oH oH
会议	hu ehH iL yi iH iL
传闻	chu aL nnH wu elL nnH
伦斯	lu elL nnH s ifH ifH
伪军	wu ehL iL jv elH nnH
伯格	bu uL oH g elL elH
伸冤	sh elH nnH yv ehH nnH
位于	wu ehH iL yv vL vH
位置	wu ehH iL zh ibM ibM
低头	di iH iH t oL uH
低音	di iH iH yi iH nnH
余	yv vL vH
余党	yv vL vH d aaL ngL
佛祖	fu uL oH zu uL uL
你好	ni iL iL h aaL oL
你的	ni iL iL d elM elM
佩玉	p ehH iL yv vH vL
使得	sh ibL ibL d elM elM
侄儿	zh ibL ibH ge erL erH
便	bi aH nnL
便	pi aL nnH
保	b aaL oL
保安	b aaL oL ga aH nnH
信	xi iH nnL
信息	xi iH nnL xi iH iH
俺家	ga aL nnL ji aH aH
候机厅	h oH uL ji iH iH ti elH ngH
假意	ji aL aL yi iH iL
假的	ji aL aL d elM elM
做	zu oH oL
停	ti elL ngH
偶尔	go oL uL ge erL erL
偷着乐	t oH uH zh elM elM l elH elL
像	xi aaH ngL
僧	s elH ngH
儿	ge erL erH
允诺	yv elL nnL nu oH oL
兆示	zh aaH oL sh ibH ibL
先	xi aH nnH
先生	xi aH nnH sh elM ngM
光文	gu aaH ngH wu elL nnH
克林	k elH elL li iL nnH
全年	qv ehL nnH ni aL nnH
八	b aH aH
公	gu uH ngH
公交车	gu uH ngH ji aaH oH ch elH elH
公司	gu uH ngH s ifH ifH
公路	gu uH ngH lu uH uL
六和	li oH uL h elL elH
关于	gu aH nnH yv vL vH
其	qi iL iH
其	ji iH iH
冀州	ji iH iL zh oH uH
内	n ehH iL
再次	z aH ehL c ifH ifL
冒着	m aaH oL zh elM elM
军功	jv elH nnH gu uH ngH
军机处	jv elH nnH ji iH iH chu uH uL
农	nu uL ngH
农机局	nu uL ngH ji iH iH jv vL vH
凉意	li aaL ngH yi iH iL
凌霄城	li elL ngH xi aaH oH ch elL ngH
凤	f elH ngL
凤凰	f elH ngL hu aaL ngH
出现	chu uH uH xi aH nnL
出镜	chu uH uH ji elH ngL
击溃	ji iH iH ku ehH iL
分娩	f elH nnH mi aL nnL
分局	f elH nnH jv vL vH
划出	hu aL aH chu uH uH
刘若英	li oL uH ru oH oL yi elH ngH
则	z elL elH
判官	p aH nnL gu aH nnH
别	bi ehL ehH
别	bi ehH ehL
到	d aaH oL
刺史	c ifH ifL sh ibL ibL
前	qi aL nnH
剑	ji aH nnL
剖	p oH uH
副庭长	fu uH uL ti elL ngH zh aaL ngL
力	li iH iL
办公	b aH nnL gu uH ngH
功绩	gu uH ngH ji iH iL
加上	ji aH aH sh aaH ngL
助手	zhu uH uL sh oL uL
势力	sh ibH ibL li iH iL
勇猛	yi uL ngL m elL ngL
勾	g oH uH
勾	g oH uL
化	hu aH aL
化	hu aH aH
北京	b ehL iL ji elH ngH
北京今天	b ehL iL ji elH ngH ji iH nnH ti aH nnH
匹	pi iL iL
十一	sh ibL ibH yi iH iH
十七	sh ibL ibH qi iH iH
十佳	sh ibL ibH ji aH aH
十八掌	sh ibL ibH b aH aH zh aaL ngL
十足	sh ibL ibH zu uL uH
千千	qi aH nnH qi aH nnH
升降	sh elH ngH ji aaH ngL
半年	b aH nnL ni aL nnH
南	n aL nnH
南	n aH aH
南京	n aL nnH ji elH ngH
南投县	n aL nnH t oL uH xi aH nnL
南郊	n aL nnH ji aaH oH
卫	wu ehH iL
历史	li iH iL sh ibL ibL
厚厚	h oH uL h oH uL
原位	yv ehL nnH wu ehH iL
原来	yv ehL nnH l aL ehH
原版	yv ehL nnH b aL nnL
去	qv vH vL
县	xi aH nnL
县县	xi aH nnL xi aH nnL
参加	c aH nnH ji aH aH
又	yi oH uL
及	ji iL iH
发现	f aH aH xi aH nnL
发短信	f aH aH du aL nnL xi iH nnL
发簪	f aH aH z aH nnH
发行	f aH aH xi elL ngH
叔	shu uH uH
叔侄	shu uH uH zh ibL ibH
取	qv vL vL
口感	k oL uL g aL nnL
古代	gu uL uL d aH ehL
古村	gu uL uL cu elH nnH
古迹	gu uL uL ji iH iL
另外	li elH ngL wu aH ehL
只是	zh ibL ibL sh ibH ibL
只需要	zh ibL ibL xv vH vH yi aaH oL
可以	k elL elL yi iL iL
可能	k elL elL n elL ngH
叶	yi ehH ehL
叶	xi ehL ehH
号	h aaH oL
号	h aaL oH
吃了	ch ibH ibH l elM elM
各种	g elH elL zhu uL ngL
合影	h elL elH yi elL ngL
吉	ji iL iH
吉他	ji iL iH t aH aH
同船	tu uL ngH chu aL nnH
名妓	mi elL ngH ji iH iL
名茶	mi elL ngH ch aL aH
后	h oH uL
后来	h oH uL l aL ehH
吐絮	tu uL uL xv vH vL
向来	xi aaH ngL l aL ehH
吗	m aM aM
吗	m aL aL
吗	m aL aH
听雨	ti elH ngH yv vL vL
吾友	wu uL uH yi oL uL
告状	g aaH oL zhu aaH ngL
命令	mi elH ngL li elH ngL
咀嚼	jv vL vL jv ehL ehH
咋	z aL aL
咋	z elL elH
咋	zh aH aH
和	h elL elH
和	h elH elL
和	hu oL oH
和	hu oH oL
和	hu uL uH
和睦	h elL elH mu uH uL
哀戚	ga aH ehH qi iH iH
响水	xi aaL ngL shu ehL iL
唐	t aaL ngH
唐山	t aaL ngH sh aH nnH
喇叭	l aL aL b aM aM
喷云吐雾	p elH nnH yv elL nnH tu uL uL wu uH uL
嗣	s ifH ifL
噼啪	pi iH iH p aH aH
囊空如洗	n aaL ngH ku uH ngH ru uL uH xi iL iL
四亿	s ifH ifL yi iH iL
回	hu ehL iH
回良玉	hu ehL iH li aaL ngH yv vH vL
因为	yi iH nnH wu ehH iL
因公	yi iH nnH gu uH ngH
园	yv ehL nnH
图上	tu uL uH sh aaH ngL
图吧	tu uL uH b aH aH
在	z aH ehL
在内地	z aH ehL n ehH iL di iH iL
在台湾	z aH ehL t aL ehH wu aH nnH
在建	z aH ehL ji aH nnL
在此	z aH ehL c ifL ifL
在第	z aH ehL di iH iL
地图	di iH iL tu uL uH
场面	ch aaL ngL mi aH nnL
坏了	hu aH ehL l elM elM
坐垫	zu oH oL di aH nnL
块	ku aH ehL
坦帕	t aL nnL p aH aL
坳	ga aaH oL
埃塞克斯	ga aH ehH s aH ehH k elH elL s ifH ifH
城主	ch elL ngH zhu uL uL
城内	ch elL ngH n ehH iL
城北	ch elL ngH b ehL iL
埔里	pu uL uL li iL iL
堪比	k aH nnH bi iL iL
境内	ji elH ngL n ehH iL
墙上	qi aaL ngH sh aaH ngL
壮丽	zhu aaH ngL li iH iL
多台	du oH oH t aL ehH
多少	du oH oH sh aaM oM
大全	d aH aL qv ehL nnH
大小便	d aH aL xi aaL oL bi aH nnL
大恩大德	d aH aL ge elH nnH d aH aL d elL elH
大特写	d aH aL t elH elL xi ehL ehL
大理石	d aH aL li iL iL sh ibL ibH
大盘走势	d aH aL p aL nnH z oL uL sh ibH ibL
大藏	d aH aL c aaL ngH
天气	ti aH nnH qi iH iL
天津	ti aH nnH ji iH nnH
天津市	ti aH nnH ji iH nnH sh ibH ibL
天湖	ti aH nnH hu uL uH
夫妇	fu uH uH fu uH uL
失去了	sh ibH ibH qv vH vL l elM elM
失禁	sh ibH ibH ji iH nnL
失落	sh ibH ibH lu oH oL
头发	t oL uH f aM aM
夺	du oL oH
奇	qi iL iH
奇	ji iH iH
奖	ji aaL ngL
套现	t aaH oL xi aH nnL
奥组委	ga aaH oL zu uL uL wu ehL iL
女士	nv vL vL sh ibH ibL
女子	nv vL vL z ifL ifL
她	t aH aH
如	ru uL uH
如何	ru uL uH h elL elH
如飞	ru uL uH f ehH iH
妃	f ehH iH
威震天下	wu ehH iH zh elH nnL ti aH nnH xi aH aL
嫩黄	n elH nnL hu aaL ngH
子婴	z ifL ifL yi elH ngH
孙	su elH nnH
孝悌	xi aaH oL ti iH iL
孟	m elH ngL
宁儿	ni elL ngH ge erL erH
它	t aH aH
安徽阜阳	ga aH nnH hu ehH iH fu uH uL yi aaL ngH
安装	ga aH nnH zhu aaH ngH
宋	su uH ngL
宏恩	hu uL ngH ge elH nnH
官邸	gu aH nnH di iL iL
宝盒	b aaL oL h elL elH
宝鼎	b aaL oL di elL ngL
宠妃	chu uL ngL f ehH iH
室	sh ibH ibL
室友	sh ibH ibL yi oL uL
家	ji aH aH
家	ji ehM ehM
家	ji aM aM
家村	ji aH aH cu elH nnH
密码	mi iH iL m aL aL
导致	d aaL oL zh ibH ibL
导航	d aaL oL h aaL ngH
寿宴	sh oH uL yi aH nnL
封堵	f elH ngH du uL uL
将	ji aaH ngH
将	ji aaH ngL
将	qi aaH ngH
小姐	xi aaL oL ji ehL ehL
小将	xi aaL oL ji aaH ngL
小工	xi aaL oL gu uH ngH
小张	xi aaL oL zh aaH ngH
尤	yi oL uH
就	ji oH uL
尿布	ni aaH oL bu uH uL
局部	jv vL vH bu uH uL
局长	jv vL vH zh aaL ngL
居心叵测	jv vH vH xi iH nnH pu uL oL c elH elL
屏幕上	pi elL ngH mu uH uL sh aaH ngL
屠夫	tu uL uH fu uH uH
岚	l aL nnH
岛	d aaL oL
岸上	ga aH nnL sh aaH ngL
崔	cu ehH iH
川	chu aH nnH
州	zh oH uH
工匠	gu uH ngH ji aaH ngL
工商局	gu uH ngH sh aaH ngH jv vL vH
工夫	gu uH ngH fu uM uM
巫	wu uH uH
巴	b aH aH
巴	b aM aM
市	sh ibH ibL
市场	sh ibH ibL ch aaL ngL
帅	shu aH ehL
师傅	sh ibH ibH fu uH uL
师傅	sh ibH ibH fu uM uM
帜	zh ibH ibL
帝	di iH iL
带	d aH ehL
帮	b aaH ngH
常山	ch aaL ngH sh aH nnH
平	pi elL ngH
年	ni aL nnH
年度	ni aL nnH du uH uL
幼稚园	yi oH uL zh ibH ibL yv ehL nnH
庆	qi elH ngL
度	du uH uL
度	du oL oH
建筑队	ji aH nnL zhu uH uL du ehH iL
开办	k aH ehH b aH nnL
开沟	k aH ehH g oH uH
弈	yi iH iL
弘	hu uL ngH
张	zh aaH ngH
张信哲	zh aaH ngH xi iH nnL zh elL elH
张力	zh aaH ngH li iH iL
张大民	zh aaH ngH d aH aL mi iL nnH
张学友	zh aaH ngH xv ehL ehH yi oL uL
张廷	zh aaH ngH ti elL ngH
弦	xi aL nnH
弹药罪	d aH nnL yi aaH oL zu ehH iL
强烈	qi aaL ngH li ehH ehL
当	d aaH ngH
当	d aaH ngL
当过	d aaH ngH gu oH oL
形容	xi elL ngH ru uL ngH
影片	yi elL ngL pi aH nnL
影迷	yi elL ngL mi iL iH
彻骨	ch elH elL gu uL uL
很轻	h elL nnL qi elH ngH
徐浩	xv vL vH h aaH oL
德里克	d elL elH li iL iL k elH elL
心仪	xi iH nnH yi iL iH
心悦	xi iH nnH yv ehH ehL
心田	xi iH nnH ti aL nnH
忠义	zhu uH ngH yi iH iL
忠孝	zhu uH ngH xi aaH oL
怀揣	hu aL ehH chu aH ehH
怎么	z elL nnL m elM elM
怒骂	nu uH uL m aH aL
怜	li aL nnH
思南县	s ifH ifH n aL nnH xi aH nnL
思想	s ifH ifH xi aaL ngL
思聪	s ifH ifH cu uH ngH
急湍	ji iL iH tu aH nnH
急行军	ji iL iH xi elL ngH jv elH nnH
情商	qi elL ngH sh aaH ngH
情深	qi elL ngH sh elH nnH
惠	hu ehH iL
想听	xi aaL ngL ti elH ngH
慕容	mu uH uL ru uL ngH
成	ch elL ngH
成语	ch elL ngH yv vL vL
我	wu oL oL
我与	wu oL oL yv vL vL
我想吃	wu oL oL xi aaL ngL ch ibH ibH
或	hu oH oL
或者	hu oH oL zh elL elL
户	hu uH uL
户外	hu uH uL wu aH ehL
所具	su oL oL jv vH vL
所列	su oL oL li ehH ehL
所部	su oL oL bu uH uL
打下手	d aL aL xi aH aL sh oL uL
打开	d aL aL k aH ehH
打开浏览器	d aL aL k aH ehH li oL uH l aL nnL qi iH iL
打狗棒	d aL aL g oL uL b aaH ngL
打电话	d aL aL di aH nnL hu aH aL
托	tu oH oH
执白	zh ibL ibH b aL ehH
扮演	b aH nnL yi aL nnL
找到	zh aaL oL d aaH oL
抽烟	ch oH uH yi aH nnH
拈香	ni aH nnH xi aaH ngH
拉	l aH aH
拉	l aL aH
拉	l aL aL
拉	l aH aL
拍摄	p aH ehH sh elH elL
拐弯处	gu aL ehL wu aH nnH chu uH uL
拼贴	pi iH nnH ti ehH ehH
指挥	zh ibL ibL hu ehH iH
指法	zh ibL ibL f aL aL
捐助	jv ehH nnH zhu uH uL
损坏	su elL nnL hu aH ehL
捡到	ji aL nnL d aaH oL
换洗	hu aH nnL xi iL iL
掠	lv ehH ehL
接	ji ehH ehH
接应	ji ehH ehH yi elH ngL
搜狐新闻	s oH uH hu uL uH xi iH nnH wu elL nnH
搜狗	s oH uH g oL uL
搜索	s oH uH su oL oL
摆	b aL ehL
摆下	b aL ehL xi aH aL
放	f aaH ngL
放回	f aaH ngL hu ehL iH
故意	gu uH uL yi iH iL
救济款	ji oH uL ji iH iL ku aL nnL
敖	ga aaL oH
教师	ji aaH oL sh ibH ibH
文昌	wu elL nnH ch aaH ngH
斟茶	zh elH nnH ch aL aH
断	du aH nnL
斯坦	s ifH ifH t aL nnL
旅游	lv vL vL yi oL uH
旗	qi iL iH
日	r ibH ibL
日升	r ibH ibL sh elH ngH
早市	z aaL oL sh ibH ibL
旱涝	h aH nnL l aaH oL
时	sh ibL ibH
旺盛	wu aaH ngL sh elH ngL
昌	ch aaH ngH
明天	mi elL ngH ti aH nnH
易于	yi iH iL yv vL vH
易地	yi iH iL di iH iL
昔日	xi iH iH r ibH ibL
昨	zu oL oH
是	sh ibH ibL
是个	sh ibH ibL g elH elL
是否	sh ibH ibL f oL uL
是多少	sh ibH ibL du oH oH sh aaL oL
景	ji elL ngL
晴	qi elL ngH
更加	g elH ngL ji aH aH
更改	g elH ngH g aL ehL
更是	g elH ngL sh ibH ibL
曼尼	m aH nnL ni iL iH
曾	c elL ngH
曾	z elH ngH
最近	zu ehH iL ji iH nnL
月	yv ehH ehL
月光	yv ehH ehL gu aaH ngH
有	yi oL uL
有	yi oH uL
有勇无谋	yi oL uL yi uL ngL wu uL uH m oL uH
有的	yi oL uL d elM elM
有着	yi oL uL zh elM elM
服务站	fu uL uH wu uH uL zh aH nnL
朝	ch aaL oH
朝	zh aaH oH
木梳	mu uH uL shu uH uH
未	wu ehH iL
本	b elL nnL
本源	b elL nnL yv ehL nnH
朱	zhu uH uH
机	ji iH iH
机票	ji iH iH pi aaH oL
机顶盒	ji iH iH di elL ngL h elL elH
杂技	z aL aH ji iH iL
李	li iL iL
李宁玉	li iL iL ni elL ngH yv vH vL
李永祥	li iL iL yi uL ngL xi aaL ngH
李祥	li iL iL xi aaL ngH
李隆基	li iL iL lu uH ngH ji iH iH
村	cu elH nnH
来讲	l aL ehH ji aaL ngL
杨	yi aaL ngH
杨家	yi aaL ngH ji aH aH
林	li iL nnH
林草	li iL nnH c aaL oL
果仁	gu oL oL r elL nnH
染病	r aL nnL bi elH ngL
查看	ch aL aH k aH nnL
柳	li oL uL
格力	g elL elH li iH iL
梁	li aaL ngH
梓	z ifL ifL
梦露	m elH ngL lu uH uL
梳头	shu uH uH t oL uH
棉毛	mi aL nnH m aaL oH
棉袄	mi aL nnH ga aaL oL
椿	chu elH nnH
楼	l oL uH
楼上	l oL uH sh aaH ngL
欢叫	hu aH nnH ji aaH oL
歉	qi aH nnL
歌	g elH elH
正巧	zh elH ngL qi aaL oL
正式	zh elH ngL sh ibH ibL
正阳门	zh elH ngL yi aaL ngH m elL nnH
步骤	bu uH uL zh oH uL
武	wu uL uL
武后	wu uL uL h oH uL
武夫	wu uL uL fu uH uH
段	du aH nnL
段芝贵	du aH nnL zh ibH ibH gu ehH iL
比分	bi iL iL f elH nnH
比利时	bi iL iL li iH iL sh ibL ibH
毕业生	bi iH iL yi ehH ehL sh elH ngH
毖	bi iH iL
毛	m aaL oH
毛刷	m aaL oH shu aH aH
毫	h aaL oH
民庭	mi iL nnH ti elL ngH
民间	mi iL nnH ji aH nnH
民院	mi iL nnH yv ehH nnL
气	qi iH iL
水	shu ehL iL
永	yi uL ngL
永信	yi uL ngL xi iH nnL
永葆	yi uL ngL b aaL oL
沙发	sh aH aH f aH aH
沙尘	sh aH aH ch elL nnH
没事	m ehL iH sh ibH ibL
河北	h elL elH b ehL iL
泉眼	qv ehL nnH yi aL nnL
泉边	qv ehL nnH bi aH nnH
法	f aL aL
法院	f aL aL yv ehH nnL
泛	f aH nnL
泸定	lu uL uH di elH ngL
泸定县	lu uL uH di elH ngL xi aH nnL
洒	s aL aL
洛水	lu oH oL shu ehL iL
活	hu oL oH
活人	hu oL oH r elL nnH
派兵	p aH ehL bi elH ngH
浓积云	nu uL ngH ji iH iH yv elL nnH
海盗	h aL ehL d aaH oL
涂在	tu uL uH z aH ehL
涅槃	ni ehH ehL p aL nnH
涡流	wu oH oH li oL uH
淘宝网	t aaL oH b aaL oL wu aaL ngL
淡绿	d aH nnL lv vH vL
清汤	qi elH ngH t aaH ngH
清风	qi elH ngH f elH ngH
温尼	wu elH nnH ni iL iH
游鱼	yi oL uH yv vL vH
湍	tu aH nnH
湖	hu uL uH
湘菜	xi aaH ngH c aH ehL
湾	wu aH nnH
滨海	bi iH nnH h aL ehL
滴翠	di iH iH cu ehH iL
漩	xv ehL nnH
潢川县	hu aaL ngH chu aH nnH xi aH nnL
火箭	hu oL oL ji aH nnL
火车票	hu oL oL ch elH elH pi aaH oL
灵魂	li elL ngH hu elL nnH
灾害	z aH ehH h aH ehL
炖煮	tu elL nnH zhu uL uL
烟	yi aH nnH
烟	yi iH nnH
烟台	yi aH nnH t aL ehH
热水	r elH elL shu ehL iL
焙烤	b ehH iL k aaL oL
熊	xi uL ngH
熟悉	shu uL uH xi iH iH
燕山	yi aH nnL sh aH nnH
爵	jv ehL ehH
父亲	fu uH uL qi iH nnH
爸爸	b aH aL b aM aM
牖	yi oL uL
牛	ni oL uH
牛肉丸	ni oL uH r oH uL wu aL nnH
牡丹	mu uL uL d aH nnH
物产	wu uH uL ch aL nnL
犀牛	xi iH iH ni oL uH
独自	du uL uH z ifH ifL
独闯	du uL uH chu aaL ngL
猪鬃	zhu uH uH zu uH ngH
玄	xv ehL nnH
率领	shu aH ehL li elL ngL
王	wu aaL ngH
王	wu aaH ngL
王五	wu aaL ngH wu uL uL
现场	xi aH nnL ch aaL ngL
珪	gu ehH iH
球	qi oL uH
瑞士	ru ehH iL sh ibH ibL
瓮	wu elH ngL
瓮中捉鳖	wu elH ngL zhu uH ngH zhu oH oH bi ehH ehH
生俘	sh elH ngH fu uL uH
用	yi uH ngL
用手	yi uH ngL sh oL uL
田林	ti aL nnH li iL nnH
由	yi oL uH
申奥	sh elH nnH ga aaH oL
电	di aH nnL
电信	di aH nnL xi iH nnL
畔	p aH nnL
疯了	f elH ngH l elM elM
疾	ji iL iH
白色	b aL ehH s elH elL
百度	b aL ehL du uH uL
的	d elM elM
的	di iH iL
的	di iL iH
的	di iH iH
的人	d elM elM r elL nnH
皇帝	hu aaL ngH di iH iL
监事	ji aH nnH sh ibH ibL
盖	g aH ehL
盖	g elL elL
盛	sh elH ngL
盛	ch elL ngH
目的地	mu uH uL di iH iL di iH iL
相识	xi aaH ngH sh ibL ibH
省会	sh elL ngL hu ehH iL
看着她	k aH nnL zh elM elM t aH aH
知道	zh ibH ibH d aaH oL
石家庄	sh ibL ibH ji aH aH zhu aaH ngH
砥	di iL iL
碎	su ehH iL
碧	bi iH iL
碧绿	bi iH iL lv vH vL
社区卫生	sh elH elL qv vH vH wu ehH iL sh elH ngH
祖	zu uL uL
祖居	zu uL uL jv vH vH
神	sh elL nnH
禅	ch aL nnH
禅	sh aH nnL
种了	zhu uL ngL l elM elM
科威尔	k elH elH wu ehH iH ge erL erL
科科长	k elH elH k elH elH zh aaL ngL
秦皇岛	qi iL nnH hu aaL ngH d aaL oL
积雨	ji iH iH yv vL vL
移植	yi iL iH zh ibL ibH
程序	ch elL ngH xv vH vL
空山	ku uH ngH sh aH nnH
立	li iH iL
立誓	li iH iL sh ibH ibL
站前	zh aH nnL qi aL nnH
竹子	zhu uL uH z ifM ifM
竹影	zhu uL uH yi elL ngL
第二	di iH iL ge erH erL
第六届	di iH iL li oH uL ji ehH ehL
等	d elL ngL
签约	qi aH nnH yv ehH ehH
管	gu aL nnL
米原康正	mi iL iL yv ehL nnH k aaH ngH zh elH ngL
精心	ji elH ngH xi iH nnH
红楼	hu uL ngH l oL uH
线	xi aH nnL
线上	xi aH nnL sh aaH ngL
经	ji elH ngH
经	ji elH ngL
经典	ji elH ngH di aL nnL
经典老歌	ji elH ngH di aL nnL l aaL oL g elH elH
结	ji ehL ehH
结	ji ehH ehH
绕	r aaH oL
给	g ehL iL
给	ji iL iL
绝对	jv ehL ehH du ehH iL
续	xv vH vL
绮丽	qi iL iL li iH iL
缀	zhu ehH iL
缨	yi elH ngH
罗	lu oL oH
美国大片	m ehL iL gu oL oH d aH aL pi aH nnL
美芳	m ehL iL f aaH ngH
群众	qv elL nnH zhu uH ngL
老乡	l aaL oL xi aaH ngH
老人	l aaL oL r elL nnH
老将	l aaL oL ji aaH ngL
老赵	l aaL oL zh aaH oL
考究	k aaL oL ji oH uH
而	ge erL erH
聊斋	li aaL oH zh aH ehH
职大	zh ibL ibH d aH aL
肾	sh elH nnL
胆	d aL nnL
胜	sh elH ngL
胜	sh elH ngH
胜景	sh elH ngL ji elL ngL
胡	hu uL uH
胡军	hu uL uH jv elH nnH
胡适	hu uL uH sh ibH ibL
能	n elL ngH
能	n aH ehL
脑门	n aaL oL m elL nnH
脚下	ji aaL oL xi aH aL
脚底	ji aaL oL di iL iL
脱下	tu oH oH xi aH aL
腹	fu uH uL
腿	tu ehL iL
臣	ch elL nnH
自古	z ifH ifL gu uL uL
至	zh ibH ibL
航母	h aaL ngH mu uL uL
节目	ji ehL ehH mu uH uL
芝麻开门	zh ibH ibH m aM aM k aH ehH m elL nnH
花鸟鱼虫	hu aH aH ni aaL oL yv vL vH chu uL ngH
芳草	f aaH ngH c aaL oL
苏州	su uH uH zh oH uH
英军	yi elH ngH jv elH nnH
茂	m aaH oL
茂密	m aaH oL mi iH iL
茉莉	mu uH oL li iH iL
茶褐色	ch aL aH h elH elL s elH elL
草木	c aaL oL mu uH uL
荒谬	hu aaH ngH mi oH uL
荒谬绝伦	hu aaH ngH mi oH uL jv ehL ehH lu elL nnH
莫	mu uH oL
菜	c aH ehL
菜田	c aH ehL ti aL nnH
萍水相逢	pi elL ngH shu ehL iL xi aaH ngH f elL ngH
蒋氏	ji aaL ngL sh ibH ibL
蒿	h aaH oH
蓝精灵	l aL nnH ji elH ngH li elL ngH
蓬	p elL ngH
蔼	ga aL ehL
薄荷	bu uH oL h elM elM
蘸	zh aH nnL
蝗虫	hu aaL ngH chu uL ngH
蝼蚁	l oL uH yi iL iL
衣裳	yi iH iH sh aaM ngM
补	bu uL uL
表厂	bi aaL oL ch aaL ngL
表现	bi aaL oL xi aH nnL
衫裤	sh aH nnH ku uH uL
袖口	xi oH uL k oL uL
被	b ehH iL
被人	b ehH iL r elL nnH
被子	b ehH iL z ifM ifM
裤脚	ku uH uL ji aaL oL
西山区	xi iH iH sh aH nnH qv vH vH
西湖	xi iH iH hu uL uH
要做	yi aaH oL zu oH oL
要像	yi aaH oL xi aaH ngL
要比	yi aaH oL bi iL iL
见到	ji aH nnL d aaH oL
观音庙	gu aH nnH yi iH nnH mi aaH oL
解闷	ji ehL ehL m elH nnL
讯	xv elH nnL
设置	sh elH elL zh ibH ibL
设计	sh elH elL ji iH iL
访问	f aaL ngL wu elH nnL
诉至	su uH uL zh ibH ibL
译	yi iH iL
语	yv vL vL
语	yv vH vL
语音	yv vL vL yi iH nnH
说服	shu oH oH fu uL uH
说法	shu oH oH f aL aL
说法	shu oH oH f aM aM
谔	ge elH elL
财报	c aL ehH b aaH oL
财物罪	c aL ehH wu uH uL zu ehH iL
贫嘴	pi iL nnH zu ehL iL
贵州省	gu ehH iL zh oH uH sh elL ngL
赫赫	h elH elL h elH elL
走到	z oL uL d aaH oL
赵子龙	zh aaH oL z ifL ifL lu uL ngH
赶到	g aL nnL d aaH oL
起点	qi iL iL di aL nnL
超多	ch aaH oH du oH oH
路口	lu uH uL k oL uL
踏	t aH aL
踏	t aH aH
身亡	sh elH nnH wu aaL ngH
轩辕	xv ehH nnH yv ehL nnH
软软	ru aL nnL ru aL nnL
辞世	c ifL ifH sh ibH ibL
辣椒酱	l aH aL ji aaH oH ji aaH ngL
返回	f aL nnL hu ehL iH
还有	h aL ehH yi oL uL
这	zh elH elL
这	zh ehH iL
这个	zh elH elL g elM elM
这幅	zh elH elL fu uL uH
这是	zh elH elL sh ibH ibL
进	ji iH nnL
违拗	wu ehL iH ga aaH oL
迷	mi iL iH
追逐	zhu ehH iH zhu uL uH
送	su uH ngL
送丧	su uH ngL s aaH ngL
逛	gu aaH ngL
逮	d aL ehL
逮	d aH ehL
逾	yv vL vH
遍了	bi aH nnL l elM elM
遥控器	yi aaL oH ku uH ngL qi iH iL
那么	n aH aL m elM elM
那样	n aH aL yi aaH ngL
那段	n aH aL du aH nnL
邱爱华	qi oH uH ga aH ehL hu aL aH
邵	sh aaH oL
邸	di iL iL
邹	z oH uH
郁	yv vH vL
郓城县	yv elH nnL ch elL ngH xi aH nnL
都把	d oH uH b aL aL
酒店	ji oL uL di aH nnL
酥脆	su uH uH cu ehH iL
酷	ku uH uL
里诺	li iL iL nu oH oL
金	ji iH nnH
金簪	ji iH nnH z aH nnH
金花	ji iH nnH hu aH aH
鉴	ji aH nnL
针线	zh elH nnH xi aH nnL
铁	ti ehL ehL
铁算盘	ti ehL ehL su aH nnL p aL nnH
铁索桥	ti ehL ehL su oL oL qi aaL oH
铁观音	ti ehL ehL gu aH nnH yi iH nnH
银	yi iL nnH
银屏	yi iL nnH pi elL ngH
锦	ji iL nnL
镶制	xi aaH ngH zh ibH ibL
长	zh aaL ngL
长	ch aaL ngH
长安	ch aaL ngH ga aH nnH
长龙	ch aaL ngH lu uL ngH
门柱	m elL nnH zhu uH uL
门楼	m elL nnH l oL uH
阁	g elL elH
阙	qv ehH ehH
阙	qv ehH ehL
队	du ehH iL
阡	qi aH nnH
防	f aaL ngH
阳世	yi aaL ngH sh ibH ibL
阴曹	yi iH nnH c aaL oH
阴道	yi iH nnH d aaH oL
陆	lu uH uL
陆	li oH uL
陈	ch elL nnH
降龙	ji aaH ngL lu uL ngH
难道	n aL nnH d aaH oL
雅	yi aL aL
雪山	xv ehL ehL sh aH nnH
露出	lu uH uL chu uH uH
青翠欲滴	qi elH ngH cu ehH iL yv vH vL di iH iH
青色	qi elH ngH s elH elL
静谧	ji elH ngL mi iH iL
静音	ji elH ngL yi iH nnH
靠前	k aaH oL qi aL nnH
韦恩	wu ehL iH ge elH nnH
音量	yi iH nnH li aaH ngL
页	yi ehH ehL
顺着	shu elH nnL zh elM elM
颁赐	b aH nnH c ifH ifL
频发	pi iL nnH f aH aH
风光	f elH ngH gu aaH ngH
飞	f ehH iH
飞驰	f ehH iH ch ibL ibH
马赛克	m aL aL s aH ehL k elH elL
马蹄	m aL aL ti iL iH
高	g aaH oH
鬼魂	gu ehL iL hu elL nnH
魏	wu ehH iL
鲜卑	xi aH nnH b ehH iH
鸡	ji iH iH
鸡皮	ji iH iH pi iL iH
黄	hu aaL ngH
黄杨	hu aaL ngH yi aaL ngH
默默地	mu uH oL mu uH oL d elM elM
龙	lu uL ngH
龙井	lu uL ngH ji elL ngL
龙湖	lu uL ngH hu uL uH
